rukhmabai	kinkar
lakshmi	jeyasingh
sanah	katikaneni
panna	csathish
sonabai	amberdeep
yashica	ramniklal
rita	harmanpreet
minmini	gurcharan
sulis	vietnam
sindhu	shantisagar
venkatesan	caesar
suvarna	farhaan
mishra	joy
debjani	murthy
saili	kirupanandha
mumtaz	mujaddid
iswarya	jon
gole	thoudam
chumki	gangadhara
venba	khub
hemalata	martin
gangubai	ranadhir
afshan	tulsi
kasthuri	jan
pooja	yousaf
anamika	kadri
sheoran	braja
charmy	jonty
gulzar	somnath
surekha	tarachand
rubab	abinash
lin	arabinda
minakshi	nawazuddin
dipika	bhagirath
pranjal	najm
sahithya	la
vijayaraje	taiyabur
raashi	dwiban
jacqueline	mani
narayani	umesh
jyothika	chandrabhan
belli	venkatesan
anjali	bhargav
ashmita	vashist
hima	janmeja
chaware	aalap
butta	ishwar
saara	thangso
kashibai	bhimreddy
pratima	majhi
mitali	waryam
sajitha	samir
srubabati	mehr
regina	jassi
golma	thiruvenkatachari
zobeda	mannargudi
maive	kc
laishram	sulalit
roma	bherulal
harita	naẓīr
anindita	bhanujeet
padmawati	zakir
bijayini	sankalp
manikuntala	thongkhosiem
gulki	ashish
leema	prabodh
mayilamma	salil
eesha	shridhar
gursharan	azad
patta	punathil
sara	shyama
rutuparna	bikalananda
nmami	jnan
kainaat	kaunain
pragathi	dibakar
paramjeet	bibhudutta
kajal	ponjikara
harsimrat	rayudu
dharma	harpal
sulagna	kulamani
lalsangzuali	veliyam
ragini	jaswant
kary	ataur
anchal	shakeeb
mithra	sadruddin
bima	shamim
diksha	wungngayam
kottayam	beant
anajli	rajender
shrutika	lalit
